
NO texture/sky1.xpm
SO texture/sky1.xpm
WE texture/sky1.xpm
EA texture/sky1.xpm
C 45, 45, 255
F 10, 57, 150
 
1111111111111111111111111111111111111111111111111111111111111111111111111111111111111111111111111111111111111111111111111111111111111111111111111111111
1001000000001001000000000000000000000001000000000001000000000001001000000000001000001001000001000001001000001001000000001000000000000001000001000000001
1001111001111001001111111111001111111111111001111111001111001001001111001111111111001001111001111001001111001001001001001001111001111111111001001111111
1001001001000000001000001001001001001000000001000000001000001001000000001000001000000001000001000000000000000000001001001001000000001001001000000000001
1001001001111001001001001001111001001111111001111111001111001111111001001111001001111111001111111001001111001111111001001111111001111001001001111001111
1000000000000001001001001000001000000000001000001001000001000001000001001000000000000001000001000001000001000000001001001001001001001000001001000000001
1111111111111001111111001111001001111001111111001001001111111111001001111111001001111111001111001001111111001111111111111001001001001111001001111001111
1000000001000000001001000000001001001000000001001001000001000000001000000001001001001000001001001000000001000001001000000000000000001000001000001000001
1001111001001111001001001111111001001111001111001001111001001001001111001001111001001111001001111001001111001111001001111111001111111111001111001111001
1001000000001001000000000000000001001001001000000001000000001001001000001000001000000000001000000001001000000001000001000001000001001000001000001000001
1111001001111001111001001111001111001001111001111001001111111111111001111001111111111111001111001001111111111001001111001111111001001111001111001111111
1001001000000000001001001000001001000001000000001001000000001001000001000001001000001000000000001000000001001000001000000001001001001000000000001000001
1001001001111111111001111111001001111001001001001001111111001001001111111001001001111111111001001111111001001111001001111001001001001111111001111111001
1000001000000001001001000000001001000001001001001000001000000001000001000001000000000001000001000001000001001000001001000000000000000001001000000001001
1111111111111001001111111001001001001111111001111111001111001001001111111111111001111001111001001111111001001111111001111111111001001111001111001001001
1000000000001001000001000001000000000001000001000001001000001001001000000000001001000001001001001000001001001001001000000000001001001000000000001000001
1111111111001111111001001111111111111001111001001111001001111001111111001001001111111001001111001111001111001001001001001111111111111111001111001111111
1001001000001001001000000000001001000000001001001000000001001000001000001001001000001000000000001001000000000001001001000001000000001000001000000001001
1001001001111001001001111111111001111001001111001001111111001111111001001111001001111111001111001001111001001001001111001111001111001111111111001111001
1000000001001000001001000001001000000001000000001001000001001000000001001000000001001001001000001000001001001000000000000000000001001000001000001000001
1001111001001111001111001111001111001111001001111001111001001111001111111111001111001001111001111001001111111001111111111111111001111111001111001001111
1000001001001000000000001000001000000001001000000000000000001000000001000000000001000000000001000001000001001000001000000000001000001000000001000000001
1111001111001001111001001001111111111111111111111111111001001001111001111111001001001111111001111111111001001111001001111111111001111111001111001001001
1000000000001001000001001001000000000001000000000001000001001000001001000001001001001000000000001001001001001000000001001000000001001001001000001001001
1001111111001001111111001001111111111001111111111001001111001001111111111001111001111111001111111001001001001111001111001111001001001001001001111001111
1000001000000001000001000000001001000001000001000000000001001001000000001000001000000001000000000001000001000001001000000000001000000000000000001000001
1001001001111001111001001111001001111001111001111001001111111111111111001111001001111111111111001001111001001111001001111001111111001111001001111001111
1001001001000001000000001000001000001000000000000001001001000000000000000001001001000001000000001000001001001001001001000001000001001001001000001001001
1111111001111001001111111001001111001001001111001111111001001001111111111001001001001111001111111001001001001001111001111001001111111001111111111111001
1001000001000001001001000001000001000001001001001001001001001001000000000000000001000000001000000001000001000000001001001000001000001000000001000000001
1001001111111001001001111111111001001111111001001001001001111001111111111001111111111001111001111111001001111001111111001111111001111001111001001111111
1000000000001001001000000001001001000001001000000000001000001001000000000000000001000001000000000001001000000001001001000001001001000001000001000000001
1001111001111001111111111001001111001001001111111001001111001111001111111001001111001001111111111001001111001111001001111001001001001111111001001001111
1000001001000001001000000001001001001001000000001001001001000000000001000001000000001001000001001001001001000001001000000001001001000001000001001000001
1111111111001111001001111111001001001001001111111111001001001001111111111001111001111111111001001001111001111001001001111111001001001111001001001111111
1000000000001001001000000000001001001001000001001000001000001000001001000001001001001000001001001001000000000000001000001000000001000001001001000001001
1001111001001001001111111001111001111001001111001001001111111001111001001001001001001111001001001111111001111001111111001111001111111001001001001001001
1000001001001000001000000001001000000001000000001001000001000000001001001000001001000000000000000001000000001000001001000000001000000001001000001000001
1001111001001111001001111111001001111111001001111111001001111001001001001001111001111111001111001001111111111001111001111001001001111111111001111001111
1001000001000001000000001000000000001000001001000001001000001001000001001000001000001000000001001001001000000001000001000001001000000000001001001000001
1111001111001001001111001001001001001001111111111001001111111111001001111001001001111111001111111111001111001001001111111001001111001001001111001001001
1000000001001000000001000001001001000001000001000000001000000001001001001001001000000000000001001000000000001001000000000001001000001001000000001001001
1001111111001111001001001001001111001111111001111001001001111111001111001001111111001111001111001111111111001001001111111111001001111111001001111111001
1000001000000001001001001001000001000001000000001001000000001001000001000000001001001000001000000000000000001000001000001000000000001000001001001000001
1111001001001111001111111001111001111111111111001001001001111001001001111111111001111001111111001111111001001111001001111111111001001111111111001111001
1000001001000001000001001001000000000001000000001001001000000000001001000000000001001001000001000001000001000001001001000001000001000000000001000001001
1001001111111001001001001111001111111111001111111111111111111001111001001001001001001111001001111001111111111001111001001111001111111111111111001111001
1001000000001001001000000001001000000001000000001000001001000000001001001001001000001000001000000000001000001001000000000000000001001000001000001000001
1111111111001001111111111111111001001111111111001001111001111001001111001111001001001111111111001001111111001001111111111111111111001111001001001001111
1001000001001000000001000000001001000001000001000000001000001001000000000001001001001000001000001000001001001000000001000000001000001000000001001001001
1001001111111111111111111001111001111111001001111111001111001111001001111111111111111111001001001001111001001111111111111111001001001001111001001001001
1000001001000000000000001001001000000000001001001000000000000000001001001000000000000000000001001000001001000001000001001000001001000001000001000000001
1001001001111001111001111001001111001111001111001111001001111111001111001111111111001001111001001111001001111001111001001001001111001001001111001111001
1001000000000000001001001001001000001000000001000000001000001000001000000001001001001000001001000001000001000000001000001001000000001001001000001000001
1111001111111111001111001001001111111111001111001001001111111001111001111001001001001111001111111111111111001111111001111111001111111001111001001111001
1000001001001000001000001000000001000000000000001001000001001000001001000000001000000001000000001001000001000000001001001000000001001001000001000001001
1001111001001001001001111001001111111001111111111111001111001111111111001111111111111111111001001001001111001111001001001111111111001001001111001111111
1001001001001001001001001001001000000001000000001000000000000001001000000001000001000001000001001000000001000001001000000000001000000001001000001000001
1001001001001001001001001001111001001111001111111111001111111111001111001111111001001111111111111001111001111001111111001111001001111111111111111111001
1000001000000001001000001000001001001001000001000000001001000000000001000000000001001000001001000001000000001000001000001000000001001000000001001000001
1111111001111001111001001001111111111001001111001111111001111111001111001111111111001111001001111111111001001001111111001111111001001001111001001111001
1000001001000000000001001000000001001000000001000000000000001000000000001000000001000000001000001001001001000000001000000000001000001001000000001000001
1001111111111001111111111111001111001111111001001111001001111111111001111001111111001111001001001001001001001001001111001001111111001001111111111001001
1000001000001000000001000000001000001001000000001000001000001000000000001000001001001000001001001000000001001001001000001001001000000000000000001001001
1001111001111001111001001111111001111001111111001111001111111111001001001111001001111001111001111001111111001111111111001111001111111111001001111001001
10000010010000000010000000000010000000000000010010000000000010010010N1001001000000001000000001000000001001001001001001001000001000000001001001000001001
1001111001001001111001001001001111001001111111111001001001001001001111001001001111001001111001111001111001111001001001001111001111111001111111001111111
1000000000001001000001001001001000001000000000001001001001001000001001001000001000000000001000000000001000000000000000000000001000000001001001000001001
1001001111111111111111001111001001001001111111111001001111111001001001111111111001001111001001111111001001111111111111111111001111111001001001001111001
1001000001000000001001001000000001001001000000001001000000001001000000001000000001000001001000001001001000001000000000000000000001000000001000000000001
1111001111001001111001001111001111001111001111001111001111001111111001001111001001001111111111111001111111111111111001111001111111111001111001111111111
1000001000001001000000001001000001000000000001000000000001000000000001001000001001001000001000001000001000001000001000001000001000000000001001000001001
1001111111001001111111001001111001001111001111111111001111001111001001111001111001111001001111001001001001001001001111111001001001111001111001111001001
1000000000001001001000001000001001001001000001001000000001001001001000000001001000000001000000001001001001001001000001000001000001000001000000000001001
1111001111111111001111111001001001111001001001001111111001111001111001111111001001001001111001111001001111001111111001001111111001111111001111111111001
1000000000000001000000000001001001000000001000001000000000001000001001001000000001001001000000000001000001000000000001000001000000001000000001000000001
1111001001111111001111001111001111001001001001111111111111001111001001001001001111111111001111111111111111001111111001001111001001111111001111001001001
1000001000000001001001001000001000001001001000001001000000001000000001000001000001000001001000001000000000001000000001000001001000000001001000001001001
1111111001111001111001111001001111001001001111001001111111001111111001001111111111111001111001111111001001001111111001001111001001111001001111111111001
1000000001000001000000001001000000001001001000001001000001001000001001000001000001001001001001000001001001001000001000001000001000001001001001000000001
1111111111001111001001001001111111111001111111001001111001111001111111111001001111001001001001111001001111001001111111001111001001111001001001111001111
1000000000000001001001001001000000000001000001000000000000000001001001001001000000000001000001000001000001001000000000001000001001000001001000001000001
1001111001111111001111111111111001111001111001001111111111001111001001001001001001111111001001001111111001001111001111111111001001001111001111001001111
1000001000001001000001000001000001001001000001000001000001000000001000001001001001000001001000000001000001000001000000001001001001000000000000000000001
1001001111001001001111001001001001001001001111001111001111001001111001111001001111001001001111111001001111111001111111111001001001001111111001111001111
1001001000001000000001001000001000001001000000000000000001001000001000001001001000001000001000000001000001000000000001000001001001000000001001000000001
1111111111111111001001111111111001111111111111001111001111111111111001001001001111111111111001111111111111111001111001111001111001001111001111111111001
1000000001000001001000000000001000001001000000000001001000000000000001000001000001000000001001000001000000000001001001000000001001000001000001001000001
1001111001001111111111111001001111001001111001111001001111111111111001001111001111001111001001001001111111111111001111001111111111001001111111001111111
1000001000000001001000001001001001000001000000001001000000000001001001000000000000000001000001001001000000000000000001000000000000001000000001000000001
1111001111111001001001111001111001001111001001111111001111001111001111111111111111111001001111001111111111111001001001001111001111111111001001001111001
1000001000000000001000000000001000000001001001000001000001001000001000000001000000001001000000001001000001000001001000001000001000001000001000000001001
1001111111001111111111111111001001001111111111111001111001111001001001111111001111001111001111001001001111111001001111111001111111001111001111111001001
1000000001000000001001000001000001001001001000001000000001000001001001000001001001000000001000001000001001001001001001000001001000000001001000000001001
1001111001111111001001001111001111111001001111001111111001001001111001001001111001111111111001001111001001001111111001111111001001111111111111111111001
1001000000000001001000000001000000000001000001000001000001001000000000001001000000001000001001000001000000000000001000001000000000000000000000000000001
1111001111001001001001111001001001001001111001001111001111001111111111001001001111111111001111111111111111111001111001111111111001111111001111111001111
1000000001001001000000001001001001001000001000001000000000001000001000001000001000000001000000001000000001001001000000001000001001001001000000001001001
1001111111001111111001001111111001111111001111001001001111001001111111001111001111001001001001001111111001001001111001001111001001001001001001001111001
1000000001001000000001000000000000000001000000001001001000000001000000001000000000001000001001001000000000000000000001000000000001000000001001000000001
1111111111111111111111111111111111111111111111111111111111111111111111111111111111111111111111111111111111111111111111111111111111111111111111111111111
