
NO texture/etoiles.xpm
SO texture/iron.xpm
WE texture/pipe.xpm
EA texture/sure.xpm
C 45, 45, 45
F 89, 57, 24

        1111111111111111111111111
        1000000000110000000000001
        1011000001110000000000001
        1001000000000000000000001
111111111011000001110000000000001
100000000011000001110111111111111
11110111111111011100000010001
11110111111111011101010010001
11000000110101011100000010001
100000000000000011000000100S1
10000000000000001101010010001
11000001110101011111011110001
11111011 1110101 101111010001
11111111 1111111 111111111111