
NO texture/iron.xpm
SO texture/iron.xpm
WE texture/iron.xpm
EA texture/cacs
C 100, 90, 100
F 99, 67, 34

111111111111111
100001001000001
100000000001001
1000000S0001001
100000000000001
111111111111111